1 0 0 0 0 0 0 0 0 0 0 0 0 0 0
0 8 8 8 8 8 8 8 8 8 8 8 8 8 0
0 0 0 0 8 8 8 8 0 0 0 0 3 0 0
8 8 8 0 8 8 8 8 0 8 8 0 0 8 8
8 8 8 0 8 0 0 0 0 0 8 0 8 8 8
8 8 8 0 8 8 0 8 8 0 8 0 8 8 8
8 8 8 0 8 8 0 8 8 0 8 0 8 8 8
8 0 0 0 0 0 0 8 8 0 0 5 8 8 8
8 0 8 8 8 8 0 8 8 8 8 0 8 8 8
8 0 8 8 8 8 0 8 8 8 8 8 8 8 8
8 0 0 0 0 0 5 8 8 0 8 8 8 8 8


# Kí tự:
0 grass
1 player
3 slime
8 box