1 8 8 8 8 8 0 0 0 8 8 8 8 8 8
0 2 0 2 0 2 0 2 0 2 8 2 0 2 8
0 0 0 0 0 0 0 0 0 0 0 0 0 0 8
8 2 0 2 0 2 0 2 0 2 0 2 0 2 8
8 0 0 0 0 8 8 8 8 0 0 0 0 0 8
8 2 0 2 0 2 0 2 8 2 0 2 0 2 8
8 0 0 0 0 8 8 0 8 8 8 0 0 0 8
8 2 0 2 0 2 0 2 0 2 0 2 0 2 8
8 0 0 0 0 0 0 0 0 0 0 0 0 0 8
8 2 8 2 8 2 0 2 0 2 0 2 0 2 8
8 8 8 8 8 8 8 8 8 8 8 8 8 8 3


# Kí tự:
0 grass
1 player
3 simple enemy
4 advanced enemy
5 ghost
8 box